{
	"id" : 2,
	"goal" : 100,
	"moves" : 10,
	"width" : 9,
	"height" : 9,
	"map":
	[
		[1, 0, 0, 0, 0, 0, 0, 0, 1],
		[0, 1, 0, 0, 0, 0, 0, 1, 0],
		[0, 0, 1, 0, 1, 0, 1, 0, 0],
		[0, 0, 0, 0, 1, 0, 0, 0, 0],
		[0, 0, 1, 1, 0, 1, 1, 0, 0],
		[0, 0, 0, 0, 1, 0, 0, 0, 0],
		[0, 0, 1, 0, 1, 0, 1, 0, 0],
		[0, 1, 0, 0, 0, 0, 0, 1, 0],
		[1, 0, 0, 0, 0, 0, 0, 0, 1]
	]
}