{
	"id" : 4,
	"goal" : 100,
	"moves" : 10,
	"width" : 8,
	"height" : 5,
	"map":
	[
		[1, 0, 1, 0, 1, 0, 1, 0],
		[1, 0, 1, 0, 1, 0, 1, 0],
		[0, 1, 0, 1, 0, 1, 0, 1],
		[0, 0, 0, 0, 0, 0, 0, 0],
		[0, 0, 0, 0, 0, 0, 0, 0]
	]
}