{
	"id" : 5,
	"goal" : 100,
	"moves" : 10,
	"width" : 8,
	"height" : 8,
	"map":
	[
		[0, 1, 0, 1, 0, 1, 0, 1],
		[1, 0, 1, 0, 1, 0, 1, 0],
		[0, 1, 0, 1, 0, 1, 0, 1],
		[1, 0, 1, 0, 1, 0, 1, 0],
		[0, 1, 0, 1, 0, 1, 0, 1],
		[0, 0, 0, 0, 0, 0, 0, 0],
		[0, 0, 0, 0, 0, 0, 0, 0],
		[0, 0, 0, 0, 0, 0, 0, 0]
	]
}